148
121 38 40 37 56 86 118 95 55 59 44 115 98 63 100 133 46 20 65 121 89 80 96 126 56 74 25 55 28 43
106 39 73 108 77 62 86 105 106 70 59 42 28 63 47 104 38 83 108 130 46 89 100 148 109 34 83 47 62 63
106 109 65 55 41 58 54 110 106 101 80 66 56 32 87 83 88 32 51 97 119 49 84 132 39 87 100 91 108 112
101 83 99 123 29 35 27 93 73 82 100 77 29 28 104 86 120 86 31 72 101 112 122 114 28 35 26 70 78 56
69 125 92 121 57 70 78 66 82 109 98 61 58 75 60 79 80 77 68 95 113 99 96 50 72 106 89 133 116 127
105 94 104 77 61 39 52 119 121 104 93 59 44 65 80 41 105 86 98 99 70 81 50 79 111 59 77 108 68 136
66 90 39 99 88 103 105 113 77 54 117 103 97 124 100 96 109 117 91 86 66 67 72 23 23 53 36 120 101 133
91 122 120 96 103 108 128 104 96 102 85 64 72 66 90 65 45 31 95 112 37 38 81 66 20 66 99 93 45 95
122 54 57 55 71 100 51 63 56 105 38 83 71 92 48 101 87 56 89 95 91 71 53 77 83 70 80 61 90 40
118 37 60 88 54 105 67 81 96 87 60 96 63 111 93 136 107 89 59 79 122 108 94 34 64 98 79 39 92 99
118 111 55 105 118 126 122 84 95 65 62 53 62 65 106 126 93 106 109 123 107 54 22 97 70 116 104 89 76 107
100 75 109 66 105 50 57 83 103 96 67 30 90 107 121 59 88 90 46 28 16 13 33 83 40 109 73 19 43 62
39 56 106 70 121 64 34 99 115 61 56 70 77 103 93 29 57 44 108 55 17 42 75 74 74 82 59 37 34 57
104 52 111 115 44 42 91 74 115 99 105 70 99 47 106 85 82 48 82 100 38 84 58 29 33 116 105 117 73 101
42 35 84 76 72 93 85 39 31 98 88 52 74 23 65 114 40 61 74 97 45 109 35 55 80 69 74 105 75 99
90 122 114 71 108 80 108 48 20 43 85 111 44 48 111 95 64 47 64 84 78 110 117 48 100 81 69 107 75 63
46 45 53 68 44 29 70 88 66 97 68 98 27 59 60 85 96 79 47 90 64 58 63 65 54 79 69 76 60 66
62 67 111 71 69 93 103 93 90 58 50 50 57 58 62 119 91 53 82 109 101 26 68 50 84 115 83 87 97 56
122 110 60 74 60 97 55 62 88 111 121 52 89 77 39 55 97 83 75 105 62 25 37 85 60 56 100 60 52 79
63 44 36 99 34 84 47 60 92 64 92 47 55 53 100 25 61 82 64 111 104 90 45 93 92 101 111 112 66 84
77 85 33 88 40 82 28 86 80 48 68 65 58 67 50 77 114 87 66 47 40 45 45 50 41 76 36 40 90 45
43 111 116 85 66 72 21 66 98 73 80 104 98 31 65 38 100 84 64 19 38 23 106 61 89 48 35 43 101 52
86 117 124 127 96 77 58 71 123 109 70 38 18 45 98 89 53 67 78 46 64 85 96 81 42 29 45 96 123 69
36 76 92 122 41 73 72 110 74 40 32 104 72 61 113 106 55 66 57 39 36 102 124 47 87 29 32 54 121 47
27 111 61 83 83 123 108 75 77 77 37 101 54 56 128 111 122 77 64 50 30 126 128 86 58 81 83 106 100 105
29 81 37 38 110 122 68 39 72 90 37 73 109 30 57 114 102 103 50 42 94 100 52 43 95 74 25 70 90 96
100 105 95 33 81 43 70 122 118 79 80 36 93 28 32 121 105 60 88 46 59 52 104 80 94 109 43 25 70 46
58 85 81 28 41 81 57 76 92 103 39 41 60 59 92 132 38 34 71 69 49 57 102 63 73 36 64 48 98 88
53 40 104 70 39 33 33 58 83 90 60 121 77 113 136 104 86 73 19 32 103 44 60 89 64 77 98 79 77 42
76 105 43 60 117 110 111 96 117 104 125 114 97 103 115 114 82 103 26 33 108 34 67 85 76 39 37 97 99 23
