138, 138, 138
58 102 59 95 60 83 75 59 75 52 50 88 92 73 67 79 82 59 102 55 117 89 100 46 47 93 78 88 102 106
87 80 57 66 80 43 64 62 84 85 42 31 26 26 78 111 48 54 103 86 69 114 75 77 50 94 53 82 105 46
120 115 93 29 46 104 97 74 63 92 33 76 76 73 112 129 98 98 55 89 96 107 100 59 73 68 80 108 67 27
41 113 113 103 38 81 27 53 94 75 96 108 114 107 98 62 87 87 39 67 72 69 69 89 56 94 120 124 75 100
112 83 40 89 122 97 37 33 104 130 64 35 40 93 65 75 72 45 32 62 73 84 55 109 65 117 37 107 89 89
59 106 101 96 104 92 81 33 45 102 68 88 50 79 84 89 86 56 60 79 52 45 41 81 37 74 40 71 46 37
29 89 58 51 32 42 26 64 20 50 76 122 113 91 73 85 32 66 38 64 71 113 84 43 50 18 88 108 105 78
61 38 12 86 84 71 27 31 30 91 110 104 71 75 122 114 43 58 105 114 75 69 56 82 83 23 70 59 105 68
93 75 60 53 89 47 103 99 42 38 97 115 65 35 45 113 40 78 125 111 101 100 49 86 69 84 53 36 56 47
58 78 91 52 109 98 93 43 69 80 78 80 110 54 27 51 97 138 138 64 71 31 86 116 54 63 90 31 50 76
20 75 117 82 91 68 106 82 72 99 82 98 64 66 54 64 76 91 138 66 45 60 60 115 95 73 54 86 92 54
52 76 78 60 37 74 127 113 79 55 69 43 76 73 82 98 82 84 74 110 103 113 109 120 85 104 64 114 65 66
14 60 74 98 40 119 75 68 106 117 122 106 37 60 101 53 81 90 17 46 40 86 47 105 90 103 79 107 79 98
19 91 66 51 35 102 57 55 57 36 62 97 86 46 118 80 40 95 51 50 31 51 17 15 36 82 108 113 107 33
38 58 103 76 100 94 48 36 85 60 116 108 116 82 112 43 82 45 66 34 15 29 69 31 21 93 112 117 115 77
40 63 43 44 94 103 65 53 81 66 108 108 111 107 121 71 69 74 101 60 86 53 42 65 75 110 62 45 56 34
55 96 93 90 68 57 92 67 102 73 58 45 56 90 53 73 29 33 40 37 102 115 114 60 69 100 120 86 43 22
9 33 114 57 31 37 52 45 106 109 60 68 59 109 44 75 40 83 20 34 73 104 67 104 94 115 103 66 91 19
71 111 116 48 102 65 51 56 119 67 111 110 68 78 26 53 42 87 35 48 83 86 80 120 82 48 41 37 111 54
93 111 50 92 77 59 88 25 42 34 102 116 41 71 34 81 71 113 81 39 15 80 27 37 77 113 85 91 38 64
120 58 56 30 62 35 71 22 90 82 59 90 57 38 51 64 117 113 67 75 21 81 47 96 69 102 99 50 46 118
65 102 104 59 70 97 119 70 95 35 79 74 83 38 68 85 74 91 68 74 38 77 91 30 52 34 71 123 63 121
24 111 75 48 84 57 102 83 77 102 95 30 97 59 53 65 113 47 58 103 114 97 102 24 57 84 107 93 93 127
42 40 25 68 100 74 94 53 68 130 110 28 44 48 103 65 97 63 85 106 99 70 49 45 29 64 112 92 83 108
93 85 73 96 76 119 111 62 71 112 66 86 45 85 87 100 81 84 108 77 96 33 93 117 63 36 61 37 59 47
70 105 32 70 40 88 71 90 111 101 94 34 47 119 49 71 101 107 94 97 48 75 74 55 96 72 83 54 107 122
28 122 55 95 100 104 76 34 83 112 105 43 97 113 96 115 89 68 39 97 68 56 105 43 39 105 37 99 136 113
107 97 70 78 122 91 114 12 64 47 92 109 70 71 95 91 116 86 70 102 61 96 72 42 33 69 19 70 99 116
40 36 124 119 67 100 89 36 32 46 95 73 88 39 51 26 65 73 102 108 109 74 26 32 87 75 22 62 46 76
87 84 123 80 89 73 50 36 46 53 109 88 54 92 119 63 80 66 73 98 126 38 69 54 97 125 75 69 124 86