90
57 58 60 64 70 74 75 73 70 70 71 73 74 73 71 69 69 71 74 76 76 76 74 73 73 71 69 66 64 63
57 58 61 65 71 74 74 71 68 67 69 72 74 73 71 69 69 71 73 75 75 74 73 73 73 72 71 68 66 65
57 58 61 66 71 74 73 69 65 63 65 69 72 73 71 70 70 71 72 73 72 72 72 72 74 74 73 71 69 68
57 58 62 67 73 75 74 69 64 61 62 66 70 72 71 70 71 72 72 72 71 70 71 72 74 76 76 74 72 71
57 58 62 67 73 76 74 70 64 61 61 64 68 70 71 71 72 73 73 72 71 70 71 73 76 78 78 77 74 73
59 60 63 68 73 76 75 72 67 63 62 64 67 70 71 72 73 74 74 74 73 72 72 74 77 79 79 77 75 73
63 64 66 70 74 77 77 74 70 66 65 66 68 71 72 73 74 75 76 76 76 75 74 75 77 78 78 76 73 71
70 71 72 74 77 79 79 76 73 70 68 69 71 74 75 75 76 78 79 80 79 78 77 76 76 76 75 73 70 68
78 78 78 79 80 81 81 79 76 73 72 73 75 76 77 77 78 79 81 82 82 82 80 79 77 76 74 71 68 66
84 83 82 82 82 83 83 81 78 75 74 75 77 78 78 77 78 80 83 85 86 86 84 82 79 77 74 71 68 67
87 85 83 81 81 82 82 80 77 74 74 75 77 78 78 77 77 80 83 87 89 89 88 85 82 79 75 73 71 70
86 83 80 78 78 79 79 77 74 73 73 75 77 78 77 77 77 79 83 87 89 90 88 85 82 79 76 74 74 73
80 78 74 72 72 74 74 74 72 71 71 74 76 77 77 77 77 79 82 86 88 88 86 83 80 77 75 75 76 76
74 72 69 67 68 70 71 71 71 71 72 74 75 76 77 76 76 78 80 82 84 84 82 80 77 74 73 74 76 77
68 67 64 63 64 66 68 70 71 72 73 74 75 75 76 76 76 77 78 79 80 80 79 77 74 72 71 72 74 76
66 65 63 61 62 64 67 69 72 73 74 75 75 75 76 77 77 77 77 77 78 78 78 76 73 71 69 69 71 73
67 66 63 61 61 62 66 70 73 75 77 77 77 77 77 78 79 78 77 77 77 77 78 77 74 71 68 68 69 70
70 69 66 63 61 63 66 71 74 77 79 79 79 79 80 80 81 80 79 77 77 77 78 78 76 73 70 68 69 69
74 72 68 65 63 64 67 72 76 78 79 80 80 79 80 80 81 80 79 78 76 76 77 78 77 74 72 71 72 72
77 75 70 66 63 63 67 71 75 77 78 78 77 77 76 76 77 78 78 77 75 74 75 76 76 76 76 77 78 79
79 76 71 66 62 61 64 68 72 74 74 74 73 72 71 70 71 73 74 74 72 71 71 72 73 75 77 81 83 85
78 74 69 63 58 57 59 63 67 69 70 69 69 68 67 66 67 69 71 72 70 68 67 68 69 72 77 82 86 88
76 72 66 60 56 54 56 59 62 64 65 66 67 66 65 64 65 67 69 70 68 66 65 64 66 69 73 79 84 87
73 69 63 58 54 53 54 55 57 59 61 63 66 67 67 66 66 67 68 68 67 66 65 64 65 67 70 75 80 83
71 68 63 59 57 56 56 55 54 55 58 62 66 69 70 69 69 69 68 68 67 66 66 66 66 66 67 70 75 78
72 69 66 63 62 61 59 56 53 53 57 62 67 71 73 73 72 70 69 68 67 69 70 70 69 67 67 69 72 75
74 73 71 70 70 68 64 59 56 56 60 65 70 73 75 74 73 71 69 68 68 71 74 74 73 71 69 69 72 73
78 78 78 78 77 74 68 62 59 61 65 70 73 75 75 74 72 70 69 68 70 73 76 77 76 74 73 73 74 75
82 83 85 85 83 79 71 65 63 66 71 75 77 76 74 72 70 69 69 70 72 75 77 79 78 78 77 77 77 77
85 87 88 89 86 81 73 67 65 69 74 78 79 76 73 70 69 68 69 70 73 76 78 79 80 80 80 80 79 80
