92, 92, 92
65 65 64 63 63 65 69 76 85 90 91 86 77 67 60 56 57 60 63 66 68 70 72 75 77 77 77 78 80 81
65 66 65 65 65 66 70 76 84 89 89 84 76 68 62 59 59 62 65 68 70 72 74 76 77 76 75 76 77 78
67 67 68 68 68 68 71 76 82 87 87 82 75 69 65 63 63 65 68 72 74 76 77 77 76 74 72 72 73 73
68 69 71 72 73 73 73 76 81 85 85 81 75 71 69 68 68 69 72 75 77 78 78 77 74 71 69 68 68 68
70 72 74 77 78 77 76 77 80 82 83 80 76 74 73 73 73 74 75 76 78 79 78 76 73 69 66 64 64 65
73 75 77 79 80 79 77 76 78 80 81 79 77 76 77 78 78 77 76 76 77 77 77 75 71 67 64 62 62 63
75 76 77 79 79 78 76 75 76 78 78 78 77 77 78 79 80 79 77 76 75 75 75 73 70 66 62 61 62 63
77 76 76 76 75 73 71 70 72 74 76 77 77 77 78 79 80 79 76 73 72 72 72 72 70 66 63 62 62 64
75 75 73 71 69 66 65 65 67 71 74 76 76 75 75 75 76 76 73 70 67 67 69 71 70 67 64 63 64 66
72 72 70 68 64 61 59 60 64 68 73 75 75 73 71 71 71 71 69 66 64 64 67 71 72 70 68 66 67 69
69 69 68 66 63 60 58 59 63 68 73 76 75 71 68 67 67 68 66 63 62 63 67 72 74 73 70 69 69 70
68 68 69 68 65 62 61 62 65 71 75 77 75 71 67 65 65 66 65 63 63 66 70 75 77 75 72 70 69 70
70 71 71 71 69 67 66 67 71 76 79 80 78 72 67 65 65 66 66 66 67 71 75 78 79 77 74 71 69 68
73 73 73 73 73 71 71 72 76 80 83 83 80 74 68 65 65 66 67 69 71 75 79 81 81 78 74 71 69 68
76 75 75 75 76 75 75 77 80 83 85 84 80 75 69 66 65 65 67 69 73 77 80 81 80 78 75 73 71 70
76 75 76 76 78 78 79 80 82 84 84 83 79 74 69 65 63 63 64 67 70 74 77 79 79 78 77 76 75 74
74 74 75 77 79 80 81 81 81 82 81 79 76 72 67 64 62 61 62 63 67 70 74 77 79 80 80 79 78 78
73 73 75 77 79 81 81 81 80 79 77 74 71 68 65 62 61 60 59 61 63 67 72 76 80 83 84 84 83 82
72 73 74 76 79 80 81 80 78 76 73 70 67 65 63 62 61 60 60 60 63 67 72 78 84 88 90 89 88 87
71 72 74 76 78 80 81 80 78 75 72 69 65 63 63 63 63 63 62 63 65 69 74 81 87 91 92 92 90 89
70 72 74 77 79 80 81 80 79 76 73 69 65 64 64 66 68 68 68 68 70 73 78 84 88 91 92 91 89 87
69 71 74 77 79 81 81 81 80 77 73 69 66 65 67 70 73 74 73 74 75 78 81 85 87 88 88 86 84 83
69 71 73 76 79 81 81 81 80 77 74 69 66 66 69 73 77 78 78 77 78 80 82 83 84 83 81 80 78 77
70 70 72 75 77 79 80 79 78 77 73 69 66 66 69 74 78 79 79 78 78 78 79 78 77 76 75 74 73 73
71 71 72 74 76 77 77 77 77 76 74 70 67 66 69 73 76 78 77 75 75 74 73 72 71 70 70 70 71 72
72 72 73 74 75 76 75 75 75 75 74 71 68 67 69 72 75 76 75 74 72 71 69 68 67 67 68 70 72 73
73 73 73 74 75 74 73 73 74 75 75 73 71 70 71 73 74 75 75 74 72 70 68 67 66 66 67 69 72 74
72 73 73 74 74 73 71 71 72 74 74 74 73 73 74 75 76 77 77 75 73 71 70 69 68 67 68 70 74 76
72 73 73 74 74 72 70 69 71 72 73 74 75 76 77 78 78 78 78 77 74 73 72 72 70 69 69 71 75 78
72 72 73 74 73 71 69 68 69 71 73 74 76 78 79 79 79 79 78 77 75 74 74 74 72 70 69 72 76 79
