93
80 78 75 72 70 70 72 75 79 81 82 81 78 73 67 63 62 63 65 67 68 67 64 62 61 63 68 73 77 79
80 79 77 74 72 72 73 75 78 80 80 79 76 72 67 63 63 64 66 68 69 68 66 64 63 65 69 73 76 77
80 79 78 76 75 75 75 75 76 76 76 75 73 70 66 64 63 65 67 70 71 71 70 68 68 69 71 74 75 75
77 77 77 78 78 79 78 77 75 73 72 71 69 67 65 63 64 66 69 72 74 75 75 74 74 75 75 75 74 74
72 73 75 77 80 81 81 79 75 71 68 67 67 66 64 63 63 65 69 73 76 78 79 80 80 81 80 78 75 73
68 69 72 76 80 84 84 82 77 72 68 66 66 65 64 62 62 64 68 72 76 79 80 82 84 85 84 81 76 74
66 67 70 75 80 84 86 84 80 75 70 67 67 66 65 63 63 65 68 73 77 78 79 81 84 87 87 84 79 75
68 69 71 75 81 85 87 86 82 78 74 71 70 69 67 66 65 67 70 74 76 76 76 77 81 86 87 85 81 78
73 73 75 78 82 85 87 86 84 80 76 74 72 71 71 70 70 71 74 76 76 74 73 74 78 83 85 85 81 79
78 78 78 80 83 86 86 85 83 80 77 75 74 73 73 73 74 76 77 77 76 73 71 71 74 79 82 82 80 78
79 79 79 81 83 85 85 83 81 78 75 74 73 73 74 75 77 78 79 78 76 73 71 70 72 75 77 78 76 75
78 78 79 81 83 83 83 81 79 76 74 73 72 73 73 74 76 77 78 77 76 74 71 70 70 71 72 73 72 72
75 76 78 80 82 82 81 79 77 75 74 73 72 71 71 71 72 73 74 75 74 73 72 70 69 68 68 69 69 69
72 74 77 80 82 81 80 78 77 76 76 75 74 72 70 68 67 68 69 71 72 72 72 71 69 68 68 68 69 69
69 71 75 79 80 80 78 77 77 77 78 78 77 74 71 67 65 65 66 68 70 72 72 72 71 70 69 70 72 73
66 69 73 76 77 76 75 75 76 78 80 82 81 78 74 69 66 64 65 67 69 71 73 73 73 72 72 74 76 78
66 68 71 73 74 73 72 73 75 79 82 84 84 82 78 73 68 66 66 67 69 71 73 74 74 74 74 76 79 82
69 70 71 72 72 72 72 73 75 79 82 85 86 85 81 76 71 69 67 68 69 71 74 75 75 74 75 76 79 81
73 73 72 72 72 72 73 73 75 78 82 85 87 85 82 77 73 71 70 70 70 72 74 75 75 74 73 74 76 77
79 78 75 74 74 74 74 74 75 77 80 83 85 84 81 77 74 73 73 73 73 74 75 75 74 73 72 72 72 72
85 83 80 78 77 76 75 74 73 75 77 80 82 82 79 77 75 75 76 76 76 76 76 76 75 74 73 72 71 71
91 89 85 83 80 78 76 73 71 72 74 77 79 80 78 76 75 76 78 79 79 79 78 77 77 76 76 75 74 72
93 91 88 85 82 79 76 73 70 70 71 74 77 79 79 77 77 78 80 81 82 81 81 80 79 79 79 79 79 78
92 90 87 84 81 78 75 73 70 69 69 72 75 78 79 79 78 78 80 82 83 83 82 81 81 80 81 82 82 82
87 85 82 79 77 76 74 72 70 68 68 70 74 78 80 80 79 79 79 81 82 83 83 82 81 80 81 82 83 84
82 80 77 74 72 72 73 72 70 68 67 69 74 78 82 82 80 78 78 79 80 82 82 82 80 79 79 80 81 83
78 76 72 69 68 70 71 72 70 68 67 69 73 79 83 83 81 78 77 77 78 80 81 81 79 77 77 77 79 80
75 73 69 66 65 67 70 72 71 69 68 70 75 80 85 86 84 80 77 76 76 78 80 80 79 77 77 76 77 77
73 71 67 63 62 64 68 70 70 69 69 72 77 83 88 89 87 83 79 76 75 77 78 79 79 79 78 77 76 76
72 70 65 62 60 63 67 70 70 69 70 73 79 85 90 91 90 86 80 76 75 76 77 79 80 80 80 78 77 76
