95
69 72 76 78 80 80 81 81 80 80 80 81 81 81 80 77 72 66 59 54 52 54 59 66 74 80 84 87 88 89
68 71 75 78 79 79 80 80 80 81 82 83 84 83 82 78 74 67 61 56 54 56 61 67 74 80 83 84 85 85
67 70 74 77 78 78 79 79 80 81 84 86 87 86 83 80 75 70 64 60 58 60 63 69 75 79 81 81 81 80
68 71 74 77 78 78 78 78 79 81 84 87 88 86 83 79 75 70 66 63 62 63 65 70 75 79 80 80 78 76
71 74 77 79 80 79 79 78 78 79 83 86 87 85 81 77 73 70 68 67 66 66 67 71 75 79 81 80 77 75
75 77 80 82 83 82 81 79 79 80 82 85 86 84 79 74 71 70 70 70 69 69 70 72 76 80 82 81 78 75
77 79 82 85 86 86 84 82 81 81 82 84 84 81 77 73 71 71 73 74 73 73 72 74 77 81 83 82 79 76
76 78 81 84 87 87 86 84 82 82 82 83 82 79 75 72 72 74 76 77 77 75 74 75 79 82 84 82 79 76
74 75 78 81 84 85 84 83 82 82 81 80 78 75 72 72 73 76 79 80 79 76 75 75 78 82 84 83 79 77
72 72 74 75 77 78 79 79 79 79 78 76 73 71 70 71 74 78 80 81 80 77 75 76 79 82 84 84 81 79
72 71 71 70 71 71 72 73 73 73 73 71 69 68 68 71 74 78 80 81 80 79 78 78 80 83 86 86 84 83
74 72 70 68 67 66 67 67 68 68 68 67 66 66 67 70 73 77 79 80 81 81 81 81 82 85 87 87 87 86
77 75 71 68 66 65 64 64 64 64 65 65 65 65 67 70 72 75 77 79 82 84 84 84 84 85 86 86 86 86
80 77 74 70 67 65 64 63 62 63 64 65 66 66 68 70 72 74 75 78 82 86 87 86 85 84 83 83 82 82
83 80 76 72 69 67 65 63 62 63 65 67 68 69 70 72 73 73 74 77 82 86 88 88 85 83 81 79 78 78
86 83 78 74 71 69 67 65 64 65 68 70 71 72 72 73 73 73 73 76 81 86 88 88 85 82 78 76 74 74
87 84 79 75 72 70 68 67 66 68 70 73 74 75 74 74 73 73 73 76 80 84 87 86 84 80 76 73 71 70
87 84 79 75 73 71 70 69 69 71 73 76 77 76 75 74 73 73 74 76 80 84 85 85 82 78 74 71 69 68
85 82 79 75 73 72 71 70 71 72 74 75 76 75 74 73 73 74 76 79 82 84 85 83 80 76 71 68 67 66
83 81 79 76 74 73 72 72 72 73 74 74 74 74 74 74 75 77 79 81 83 85 85 83 78 73 69 66 66 66
81 80 79 78 77 75 74 73 73 73 73 73 73 73 74 76 77 79 81 82 83 84 84 82 78 73 68 67 67 68
78 79 79 79 79 78 76 75 74 73 72 72 72 74 76 79 81 82 81 81 82 83 83 82 78 74 70 69 71 72
74 76 78 80 81 81 79 77 75 74 72 72 73 75 78 81 82 82 79 78 78 80 82 81 79 75 73 73 75 76
71 73 76 80 83 84 83 80 78 76 74 73 73 75 79 81 81 79 75 73 74 77 80 80 79 76 76 77 78 80
69 71 76 80 84 86 85 83 81 78 75 73 73 75 77 79 78 75 71 69 71 75 78 79 78 76 77 78 80 81
71 73 77 81 84 86 86 85 83 79 76 73 72 73 75 76 75 71 67 66 68 72 76 77 76 75 76 78 80 81
75 76 78 80 82 83 84 83 81 78 74 71 70 70 72 73 72 69 65 63 65 69 73 75 75 75 76 79 82 83
81 80 79 78 77 78 79 79 77 74 71 68 67 68 70 72 71 68 63 61 63 67 72 75 75 76 79 82 85 86
85 83 79 74 71 71 72 74 73 70 67 65 64 65 69 71 71 68 63 60 62 66 72 76 78 79 82 86 90 91
88 84 78 71 67 66 68 70 70 68 65 63 62 64 67 71 71 67 62 59 60 65 72 76 79 81 84 89 93 95
