90, 90, 90
82 82 81 78 73 68 64 63 64 66 70 73 78 82 85 85 83 81 79 80 80 79 77 76 76 78 79 78 76 74
83 82 79 76 72 69 66 65 66 68 70 74 77 82 84 85 82 80 79 79 79 78 75 73 74 76 78 79 78 77
82 80 77 73 71 68 67 67 69 70 71 73 76 80 82 82 81 79 78 78 78 76 73 71 71 74 78 80 80 79
81 79 75 71 69 68 69 70 71 72 72 73 74 77 79 79 78 76 76 76 76 74 71 69 70 73 77 80 81 81
80 77 73 70 69 69 70 71 73 73 73 72 72 73 75 76 75 74 74 74 74 73 71 69 70 73 76 78 79 79
80 78 74 72 70 70 71 72 74 74 74 72 71 71 73 74 74 74 73 74 74 73 72 71 72 74 76 77 77 77
80 79 77 74 73 72 72 73 76 77 76 74 72 71 71 73 74 74 74 74 74 74 73 73 73 74 74 74 74 74
81 80 79 77 75 74 74 76 79 81 81 78 74 72 72 73 75 76 75 74 74 73 72 72 73 73 73 73 73 73
81 82 82 80 78 76 77 79 83 86 86 82 77 74 73 75 77 77 76 74 72 71 70 71 71 72 72 72 74 75
81 82 83 82 80 77 78 81 86 89 89 86 80 77 76 77 78 78 75 72 69 68 68 69 70 71 72 74 76 79
81 82 83 82 79 77 78 81 86 89 90 87 83 80 79 79 79 78 74 71 67 66 66 68 70 71 73 75 79 82
77 79 80 79 76 74 75 79 84 88 89 87 85 82 81 81 80 77 73 69 67 66 66 69 72 74 75 77 80 82
71 73 74 73 72 71 73 77 82 85 86 86 85 84 83 81 79 75 72 68 66 66 68 71 74 77 78 78 79 80
64 65 66 66 66 67 71 75 79 82 83 84 83 83 81 79 76 73 69 67 66 67 69 73 77 79 79 78 77 76
59 60 61 62 63 66 70 75 78 80 80 81 80 79 77 75 72 69 67 65 65 66 69 73 77 79 79 77 74 72
56 56 57 59 61 65 71 75 78 79 79 78 77 76 73 70 68 66 64 63 63 64 67 72 76 78 78 75 71 68
54 55 56 59 62 67 72 76 79 79 79 77 76 73 70 68 65 64 63 62 62 63 66 69 74 76 76 74 70 68
54 56 58 61 65 70 74 77 79 80 79 78 76 73 70 67 65 63 63 62 62 63 64 68 71 74 75 74 72 71
56 58 60 64 68 72 75 77 79 79 79 78 77 74 71 68 65 64 64 63 63 63 64 66 69 72 73 74 74 74
60 61 64 67 71 74 75 76 76 76 77 77 76 74 71 69 66 65 65 64 63 62 62 64 66 68 70 72 74 75
65 66 67 70 72 74 74 73 73 73 73 74 74 73 71 70 68 67 66 65 63 62 61 61 62 64 66 68 70 72
71 71 71 72 74 74 73 72 71 71 71 73 73 73 72 71 70 69 68 66 64 62 60 60 60 61 62 64 66 68
77 76 75 75 75 75 74 72 71 71 72 73 74 74 74 73 72 71 70 68 66 64 63 62 61 62 62 63 64 65
82 81 79 78 77 77 76 74 73 74 75 76 77 77 77 76 74 73 71 70 68 67 66 66 65 65 65 65 65 65
86 84 82 80 79 78 77 77 76 77 79 80 81 80 79 78 76 74 72 70 69 69 69 69 69 69 68 68 68 69
87 85 82 80 79 79 78 78 78 79 81 82 82 81 80 78 77 75 72 70 68 69 70 71 71 72 73 74 75 76
86 85 82 80 80 79 79 78 78 79 80 81 80 79 78 77 76 75 72 69 67 67 68 70 71 73 76 79 82 83
84 83 81 80 80 79 79 78 78 78 77 77 76 76 75 75 75 75 73 70 68 66 66 67 70 73 77 82 86 88
81 81 80 80 80 79 78 77 76 75 74 73 72 72 73 74 75 76 75 73 70 67 65 65 67 72 77 83 88 90
79 79 79 79 80 79 78 77 75 74 71 70 69 70 71 73 75 77 77 75 72 68 64 64 66 70 77 83 88 90
