96, 96
84 82 77 71 65 62 62 65 69 73 77 79 79 77 73 69 65 62 60 59 59 62 67 72 77 80 82 82 82 82
85 82 77 71 66 63 63 65 68 71 74 77 78 76 73 70 66 64 62 60 61 63 66 71 75 78 79 80 80 79
84 82 77 71 66 64 64 65 66 68 70 73 75 75 73 70 67 66 64 63 63 64 67 70 73 75 76 76 76 75
83 80 75 70 67 67 67 67 66 66 67 69 71 72 71 69 67 66 66 66 66 66 67 69 71 72 73 73 72 72
80 77 73 69 68 69 71 71 68 66 65 66 68 69 68 67 66 66 67 67 67 68 69 70 70 71 70 70 69 69
77 74 70 68 69 73 75 75 72 68 66 66 67 68 67 66 66 66 67 68 69 69 70 70 70 69 68 68 67 67
72 70 68 68 71 75 78 78 75 71 69 68 68 69 69 68 68 69 69 70 70 70 71 71 70 68 67 66 66 66
68 67 67 68 72 77 80 80 78 75 72 72 72 73 73 72 72 72 73 72 71 71 71 70 69 68 67 66 66 66
66 66 66 69 73 78 80 80 78 76 75 76 77 77 78 77 77 77 76 74 72 70 70 69 68 67 66 66 66 66
65 65 66 69 73 77 79 79 78 77 78 79 80 82 82 82 81 81 80 76 73 70 68 68 68 67 67 67 68 68
66 66 67 69 73 77 79 79 79 79 79 81 83 85 85 85 84 84 82 78 73 70 68 68 68 68 68 69 70 70
69 69 69 71 74 77 79 79 79 79 80 82 84 86 86 87 87 87 85 81 76 72 70 70 70 70 70 71 73 74
72 72 71 72 74 77 79 80 80 79 79 81 83 85 86 87 88 89 88 85 81 76 74 72 71 71 71 73 76 78
74 73 72 73 75 78 80 81 79 78 77 78 80 82 84 85 87 89 90 88 84 81 78 76 73 72 72 75 80 83
73 72 72 72 75 78 80 80 79 77 76 76 78 79 80 81 83 86 88 88 86 84 81 78 75 73 74 78 84 88
72 71 70 71 74 77 80 80 79 77 76 76 76 76 76 77 79 82 85 86 86 85 84 81 77 75 76 81 87 92
72 70 69 70 73 77 80 81 80 79 77 77 76 74 73 73 75 79 83 85 87 87 86 83 79 77 77 82 89 93
74 72 70 70 74 78 82 83 82 81 80 78 76 74 72 72 74 78 83 87 89 90 88 85 81 78 79 82 88 91
77 75 73 74 77 81 84 85 84 83 81 79 76 73 71 71 74 79 84 89 92 93 91 88 83 80 79 81 84 86
80 78 77 78 80 84 86 86 85 82 80 77 75 73 72 72 74 79 85 91 95 96 94 90 86 82 80 80 80 80
80 80 80 82 84 86 87 86 83 80 77 74 74 74 74 74 75 79 85 91 95 96 95 91 87 83 80 78 76 74
78 79 81 83 86 87 87 84 81 76 73 71 71 73 74 74 75 78 83 88 92 93 92 90 87 84 80 76 73 71
73 75 79 83 86 87 85 82 77 72 69 67 69 71 74 74 75 77 80 83 87 88 89 88 86 83 79 74 71 69
68 71 75 80 84 84 82 78 73 69 65 65 66 70 73 74 75 75 77 79 81 83 85 85 84 81 77 72 69 67
65 68 73 77 81 82 80 76 71 67 64 64 66 69 72 74 74 74 73 73 75 78 80 82 81 78 74 70 67 65
67 69 73 76 79 80 78 75 72 68 66 65 66 69 72 74 73 71 69 69 70 73 76 78 77 75 71 68 66 64
71 73 75 78 79 79 79 76 73 70 68 67 67 70 72 73 72 69 66 65 67 70 73 74 73 71 69 68 67 66
76 77 79 80 81 81 81 78 75 71 68 67 68 70 72 73 70 67 64 62 63 66 69 70 69 68 68 69 70 70
80 81 82 84 84 84 83 80 75 70 67 66 67 70 72 72 70 66 63 61 62 64 66 66 65 65 67 70 73 75
82 83 85 86 87 87 85 81 76 70 66 65 67 70 72 72 70 66 63 61 61 63 64 64 63 63 65 70 75 77
