90, 90, 90, 90
79 81 84 87 89 89 87 82 77 72 68 66 66 67 67 67 67 69 73 79 85 89 90 88 84 81 79 79 80 81
78 80 83 87 89 89 86 82 77 73 69 67 67 68 68 67 67 69 73 80 85 89 90 88 85 82 80 80 82 83
78 80 82 85 87 87 85 82 78 75 72 70 70 70 70 68 68 70 74 80 85 89 89 87 84 81 81 82 84 86
78 80 82 84 85 84 83 81 79 77 75 73 73 72 71 69 69 70 75 80 84 87 86 84 81 79 79 82 85 88
78 79 81 82 82 81 81 80 80 79 78 77 76 75 73 71 69 70 74 78 81 82 81 78 75 74 76 80 85 88
78 78 79 80 79 79 79 80 81 82 82 81 79 77 75 72 70 70 72 75 77 77 75 72 70 70 73 78 83 87
78 78 78 77 77 76 77 80 83 85 84 83 80 78 75 72 69 69 70 72 73 72 69 67 66 67 71 77 83 87
78 77 76 75 74 75 76 80 83 86 85 83 80 76 73 71 69 69 70 71 70 69 67 65 64 66 71 77 84 87
79 77 74 73 73 74 76 80 84 86 85 81 77 73 70 68 68 68 69 70 69 68 66 65 64 66 70 77 83 86
79 77 73 71 72 74 77 81 84 85 83 79 74 69 66 65 65 67 69 70 70 69 67 65 64 65 68 73 78 81
79 77 73 72 72 75 78 81 84 84 81 77 71 66 63 62 63 65 68 70 71 70 69 66 64 63 65 68 72 74
79 77 74 73 74 76 79 81 82 81 78 74 69 64 61 61 62 64 67 70 72 73 71 68 64 62 62 64 66 67
79 77 76 75 75 77 79 80 80 78 75 71 68 65 63 62 63 65 67 71 74 74 72 68 64 61 61 61 62 62
79 78 77 76 76 77 78 78 77 74 72 69 67 66 65 65 65 66 69 72 75 76 73 69 65 62 61 61 61 61
79 78 77 75 75 75 75 75 73 71 69 67 66 66 66 66 67 68 70 73 75 75 72 68 64 62 61 61 60 60
78 77 75 73 72 72 72 71 70 68 66 65 65 65 66 67 69 70 72 74 75 74 71 67 64 62 62 61 61 60
75 74 73 71 70 69 69 69 68 66 64 63 63 64 66 69 71 73 74 75 75 74 71 67 64 63 62 62 61 61
73 72 71 70 70 70 70 70 69 67 64 62 62 64 67 71 75 76 76 75 74 73 70 68 65 64 63 62 61 61
71 71 71 71 71 72 72 72 71 69 65 63 62 65 70 76 79 80 79 76 74 73 71 69 67 65 64 62 61 60
70 70 71 72 74 75 76 76 75 72 68 65 64 67 73 79 83 84 81 78 75 73 71 70 68 66 63 61 59 58
70 70 71 73 76 78 79 79 78 75 70 67 67 70 76 82 85 86 84 80 76 72 71 69 68 66 63 60 58 57
70 70 71 73 75 78 80 81 80 77 73 69 69 72 78 83 86 87 85 81 76 72 69 68 67 65 62 60 58 57
72 72 71 72 74 76 79 81 81 79 74 70 69 73 78 83 86 88 86 82 77 71 68 68 68 67 65 63 61 60
75 74 72 71 71 74 77 80 81 78 73 69 69 72 77 82 85 86 86 82 76 70 68 68 70 70 69 67 65 64
78 76 73 70 69 70 74 77 79 77 73 69 68 71 75 79 82 83 82 79 74 69 68 70 73 74 74 72 70 68
82 80 75 71 68 68 70 74 76 75 73 70 70 72 75 78 79 79 78 75 71 69 68 71 75 78 78 76 72 70
83 81 77 72 69 68 69 72 74 75 74 73 74 76 78 79 79 78 76 73 70 68 69 72 76 79 80 77 74 71
83 81 78 75 72 70 70 72 74 74 75 76 79 81 83 83 82 81 78 75 72 69 69 71 75 79 80 78 75 72
80 80 79 78 76 75 74 74 75 75 75 78 82 85 87 87 87 86 83 78 74 70 69 71 74 77 78 78 75 74
78 78 79 80 80 79 78 77 76 75 76 79 83 87 89 90 90 89 86 81 76 71 69 69 72 75 77 77 75 74
