88, 88, 88, 88
60 60 61 63 66 71 76 78 79 76 71 65 59 56 56 59 65 71 76 79 79 77 76 76 77 78 78 78 76 75
62 62 62 64 67 72 76 78 78 76 71 65 59 56 56 59 64 69 74 76 76 76 75 76 77 77 78 77 77 77
63 63 63 65 68 72 75 77 76 75 71 66 61 58 57 59 63 67 70 72 73 74 75 76 77 77 77 77 78 79
64 64 64 65 68 71 74 75 75 74 72 69 65 62 61 62 64 66 68 70 72 74 76 78 78 78 78 79 81 82
64 63 63 64 67 70 73 75 75 75 74 74 71 69 66 66 66 67 69 70 72 74 77 79 80 80 80 81 84 86
62 61 61 62 65 70 73 76 76 77 78 78 77 75 72 71 70 70 71 71 73 75 76 78 80 80 81 83 85 87
60 60 60 62 66 71 76 79 80 81 82 82 81 78 75 74 72 72 71 72 72 73 74 75 77 78 80 82 85 86
60 61 62 65 69 75 80 83 85 85 85 84 82 79 76 74 72 71 70 70 71 71 70 71 72 74 76 78 80 82
63 64 66 69 73 79 83 87 88 88 86 84 81 78 75 72 70 67 67 67 68 68 67 67 68 70 72 73 74 75
67 68 70 73 77 81 85 87 88 88 86 83 80 77 74 72 68 65 64 64 65 65 65 66 67 69 69 69 68 67
72 73 74 76 78 81 84 85 86 85 83 81 78 76 74 71 68 64 63 63 64 64 65 67 70 71 70 67 64 62
77 77 76 77 78 79 81 81 81 80 78 77 76 75 74 72 68 65 63 63 64 65 67 71 74 76 73 68 63 59
81 79 77 76 76 77 78 77 77 75 74 73 73 73 73 71 69 66 65 65 65 67 70 75 79 80 77 71 64 60
80 78 75 74 74 75 76 75 74 72 71 71 71 72 71 70 69 67 67 67 67 69 73 78 82 83 80 74 67 62
76 74 72 71 72 74 76 75 73 71 70 70 70 71 71 70 69 69 69 69 68 70 74 79 83 84 81 75 68 64
70 69 68 69 72 75 76 76 74 73 71 71 71 71 71 70 69 70 70 69 69 69 73 78 82 83 80 74 68 64
65 65 66 68 72 75 76 76 75 74 74 73 73 73 72 71 70 70 70 70 69 69 72 77 81 82 78 73 68 65
62 63 65 69 72 74 75 76 76 75 75 75 75 75 74 72 71 71 72 71 70 71 73 77 80 80 77 73 69 66
62 64 67 70 72 73 73 74 75 75 75 75 76 76 75 73 72 72 73 74 74 74 75 78 80 79 77 74 71 69
63 65 68 71 71 71 71 72 74 74 74 75 76 76 76 74 74 74 76 77 77 76 77 78 79 78 77 75 75 74
61 64 67 69 69 69 70 71 72 73 73 74 75 76 76 75 75 76 78 79 78 77 76 76 76 75 75 76 78 80
57 59 63 65 67 67 68 70 71 72 72 72 73 74 75 76 76 78 80 80 78 75 73 72 71 71 71 74 78 81
52 55 58 62 64 66 67 68 70 70 71 71 72 74 75 76 77 78 79 78 76 72 70 69 68 67 68 71 77 81
51 53 57 60 62 64 65 67 69 70 71 72 73 74 75 76 77 78 79 77 74 71 68 67 66 65 66 69 75 79
53 55 58 60 62 62 63 65 68 71 73 74 75 75 75 75 75 77 78 77 75 72 70 68 67 65 65 68 72 76
59 60 62 63 63 62 63 65 69 73 76 77 77 75 73 72 72 74 75 76 75 74 72 71 69 67 66 67 70 72
66 67 67 67 65 64 64 66 71 77 80 80 78 74 71 69 68 70 73 75 76 76 75 74 72 70 68 67 67 68
73 72 72 71 69 67 66 68 73 79 83 82 79 74 69 66 65 66 70 74 77 78 78 76 74 72 70 68 66 65
78 77 76 75 72 70 68 70 75 81 84 83 79 73 68 65 63 64 67 72 76 79 79 78 77 75 73 70 66 64
80 80 79 77 75 72 70 71 76 81 85 84 79 73 68 64 62 63 66 71 76 79 80 80 78 76 74 71 67 64
